1111111111111111111111111111111111
10P0000000000000000000010000000001
1010010010001010000100010000000011
101001000X000000000000000000000001
1000000010001000001001000000111111
1000010C0C0C00C0C01001000000CC0001
1000000C0C0C0C0000C001000000C00001
10001CCCCCC0111111110100000XC00001
10000C01000010C0C0C100000000111111
10100100100010C000C10C0C0C0C0C00C1
11001011110010CC0C0100C0C111000001
1000000000000000000000000000000E01
1111111111111111111111111111111111